{
    "towerLimit": 3,
    "enemies": [
        {"x": 1500, "y": 0},
        {"x": 1500, "y": 20},
        {"x": 1500, "y": 40},
        {"x": 1500, "y": 60},
        {"x": 1500, "y": 80},
        {"x": 1500, "y": 100},
        {"x": 1500, "y": 120},
        {"x": 1500, "y": 140},
        {"x": 1500, "y": 160},
        {"x": 1500, "y": 180},
        {"x": 1500, "y": 200},
        {"x": 1500, "y": 220},
        {"x": 1500, "y": 240},
        {"x": 1500, "y": 260},
        {"x": 1500, "y": 280},
        {"x": 1500, "y": 300},
        {"x": 1500, "y": 320},
        {"x": 1500, "y": 340},
        {"x": 1500, "y": 360},
        {"x": 1500, "y": 380},
        {"x": 1500, "y": 400},
        {"x": 1500, "y": 420},
        {"x": 1500, "y": 440},
        {"x": 1500, "y": 460},
        {"x": 1500, "y": 480},
        {"x": 1500, "y": 500}
    ],
    "mosque": {
        "x": 300,
        "y": 500,
        "width":150,
        "height":150
    } 
}
